00000000000000000000000000000000000000000000000000000000000000
00000000000000000000000000000000000000000000000000000000000000
00000000000000000000000000000000000000000000000000000000000000
00000000000000000000000000000000000000000000000000000000000000
00000000000000000000000000000000000000000000000000000000000000
00000000000000000000000000000000000000000000000000000000000000
00000000000000000000000000000000000000000000000000000000000000
00000000000000000000000000000000000000000000000000000000000000
00000000000000000000000000000000000000000000000000000000000000
00000000000000000000000000000000000000000000000000000000000000
00000000000000000000000000000000000000000000000000000000000000
00000000000000000000000000000000000000000000000000000000000000
00000000000000000000000000000000000000000000000000000000000000
00000000000000000000000000000000000000000000000000000000000000
00000000000000000000000000000000000000000000000000000000000000
00000000000000000000000000000000000000000000000000000000000000
00000000000000000000000000000000000000000000000000000000000000
00000000000000000000000000000000000000000000000000000000000000
00000000000000000000000000000000000000000000000000000000000000
00000000000000000000000000000000000000000000000000000000000000
00000000000000000000000000000000000000000000000000000000000000
30000000000000000000000000000000000000000000000000000000000003
30000000000000000000000000000000000000000000000000000000000003
30000000000000000000000000000000000000000000000000000000000003
31111111111000000000000000000000000000000000000000000000000003
32222222222100000000000000000000000000000000000000000000000003
32222222222211111111111111111111111111111111111111111111111113
32222222222222222222222222222222222222222222222222222222222223
33333333333333333333333333333333333333333333333333333333333333
33333333333333333333333333333333333333333333333333333333333333
33333333333333333333333333333333333333333333333333333333333333
33333333333333333333333333333333333333333333333333333333333333
33333333333333333333333333333333333333333333333333333333333333
33333333333333333333333333333333333333333333333333333333333333
33333333333333333333333333333333333333333333333333333333333333
